NO ./texs/bluestone.xpm
SO ./texs/colorstone.xpm
WE ./texs/mossy.xpm
EA ./texs/redbrick.xpm

F 50,100,100
C 0,0,255

111111111111
100000000001
111110011111
11111DD11111
100000000001
100R00RF0R01
1000000000011111111
1000011N0011
111111111111
