NO ./texs/bluestone.xpm
SO ./texs/colorstone.xpm
WE ./texs/mossy.xpm
EA ./texs/redbrick.xpm

F 100,100,100
C 26,26,26

                                       11111111111111
        1111111111111111111111111     110000100000001
        100000000011000000000000111111100100100000001
        1011000001110R0000000000D00000D00F00000000001
        100100000000000000000000111111111111111111111
111111111011000001110R00000000001
1000000000110R0001110111111111111
11110111111111000000000010001
11110111111111011101010010001
11000000110101011100000000001
10000000000000000000000F00001
100F0R00000000001101D10000001
11000001110101011111F11100N0111
11110111 1110101 101111010001
11111111 1111111 111111111111
